...#####...
...#####...
...........
...........
...#####A..
1##########
